wwwwwwwwww
w-y----r-w
w-w----w&w
www----www
w--------w
wR-------w
wwwwwwwwww
