wwwwwwwwww
w-------Rw
www----www
w-r----r-w
w-w----w-w
w-w----w&w
wwwwwwwwww
