wwwwwwwwww
wR-----w&w
w------y-w
w------www
www----w-w
w-w----w-w
w-r----w-w
w-w----w-w
wYw------w
wwwwwwwwww