wwwwwwwwww
wR-------w
www----www
w-r----y-w
w-w----w-w
wYw----w&w
wwwwwwwwww

