wwwwwwwwww
w-g------w
wRw----w-w
www----www
w&r------w
wwww--wwww
wwww--wwww
w-w----w-w
w-y----b-w
wGw----wYw
www----www
wB-------w
wwwwwwwwww
