wwwwwwwwww
w&r------w
wwww-wwwww
---w-w----
---w-w----
---wRw----
---www----
